21 13 13 13 13 13 13 13 13 13 20 26 21 13 13 13 13 13 20 26 21 13 13 13 13 13 20 26 21 13 13 13 13 13 13 13 13 13 13 13 13 13 13 13 13 13 13 13 13 20
24 1 1 1 1 1 1 1 1 1 17 26 24 1 1 1 1 1 17 26 24 1 1 1 1 1 17 26 24 1 1 1 1 1 1 1 1 1 1 1 1 1 1 1 1 1 1 1 1 17
24 0 0 0 0 0 0 0 0 0 17 26 24 28 31 0 0 0 17 26 24 0 0 0 0 0 17 26 24 0 0 0 0 0 0 0 0 0 0 0 0 0 0 0 0 0 0 0 0 17
24 0 0 0 0 0 0 0 0 0 15 13 14 0 0 0 0 0 17 26 24 0 0 0 0 0 17 26 24 0 0 0 0 0 0 0 0 0 0 0 0 0 0 0 0 0 0 0 0 17
24 0 0 0 0 0 0 0 0 0 1 1 1 0 0 0 0 0 17 26 24 0 0 0 0 0 17 26 24 0 0 0 0 0 0 0 0 0 0 0 0 0 0 0 0 0 0 0 0 17
24 0 0 0 0 0 0 0 0 0 0 0 0 0 0 0 0 0 17 26 24 0 0 0 0 0 17 26 24 0 0 0 0 0 0 0 0 0 0 0 0 0 0 0 0 0 0 0 0 17
24 0 0 0 0 0 0 0 0 0 0 0 0 0 0 0 0 0 17 26 24 0 0 0 0 0 17 26 24 0 0 0 0 0 0 0 0 0 0 0 0 0 0 0 0 0 0 0 0 17
24 0 0 0 0 0 0 0 0 0 29 27 30 0 0 0 0 0 17 26 24 0 0 0 0 0 17 26 24 0 0 0 0 0 0 0 0 0 0 0 0 0 0 0 0 0 0 0 0 17
24 0 0 0 0 0 0 0 0 0 18 26 24 0 0 0 0 0 15 13 14 0 0 0 0 0 15 13 14 0 0 0 0 0 0 0 0 0 0 0 0 0 0 0 0 0 0 0 0 17
34 27 27 27 27 27 27 27 27 27 33 26 24 0 0 0 0 0 1 1 1 0 0 0 0 0 1 1 1 0 0 0 0 0 0 0 0 0 0 0 0 0 0 0 0 0 0 0 0 17
26 26 26 26 26 26 26 26 26 26 26 26 24 0 0 0 0 0 0 0 0 0 0 0 0 0 0 0 0 0 0 0 0 0 0 0 0 0 0 0 0 0 0 0 0 0 0 0 0 17
32 13 13 13 13 13 13 13 13 13 13 13 14 0 0 0 0 0 0 0 0 0 0 0 0 0 0 0 0 0 0 0 0 0 0 0 0 0 0 0 0 0 0 0 0 0 0 0 0 17
24 1 1 1 1 1 1 1 1 1 1 1 1 0 0 0 0 0 29 27 30 0 0 0 0 0 0 0 0 0 0 0 0 0 0 0 0 0 0 0 0 0 0 0 0 0 0 0 0 17
24 0 0 0 0 0 0 0 0 0 0 0 0 0 0 0 0 0 17 26 24 0 0 0 0 0 0 0 0 0 0 0 0 0 0 0 0 0 0 0 0 0 0 0 0 0 0 0 0 17
24 0 0 0 0 0 0 0 0 0 0 0 0 0 0 0 0 0 17 26 24 0 0 0 0 0 0 0 0 0 0 0 0 0 0 0 0 0 0 0 0 0 0 0 0 0 0 0 0 17
34 27 27 27 27 27 27 27 27 27 27 27 27 30 0 0 0 0 17 26 34 27 27 27 27 27 27 27 27 27 27 27 27 27 27 27 27 27 27 27 27 27 27 27 27 27 27 27 27 33
26 26 26 26 26 26 26 26 26 26 26 26 26 24 0 0 0 0 17 26 26 26 26 26 26 26 26 26 26 26 26 26 26 26 26 26 26 26 26 26 26 26 26 26 26 26 26 26 26 26
26 26 26 26 26 26 26 26 26 26 26 26 26 24 0 0 0 0 17 26 26 26 26 26 26 26 26 26 26 26 26 26 26 26 26 26 26 26 26 26 26 26 26 26 26 26 26 26 26 26
21 13 13 13 13 13 13 13 13 13 13 13 13 14 0 0 0 0 17 26 32 13 13 13 13 13 13 13 13 13 13 13 13 13 13 13 13 13 13 13 13 13 13 13 13 13 13 13 13 20
24 1 1 1 1 1 1 1 1 1 1 1 1 1 0 0 0 0 17 26 24 1 1 1 1 1 1 1 1 1 1 1 1 1 1 1 1 1 1 1 1 1 1 1 1 1 1 1 1 17
24 0 0 0 0 0 0 0 0 0 0 0 0 0 0 0 0 0 17 26 24 0 0 0 0 0 0 0 0 0 0 0 0 0 0 0 0 0 0 0 0 0 0 0 0 0 0 0 0 17
24 0 0 0 0 29 27 30 0 0 0 0 0 0 0 0 0 0 17 26 24 0 0 0 0 0 0 0 0 0 0 0 0 0 0 0 0 0 0 0 0 0 0 0 0 0 0 0 0 17
24 0 0 0 0 17 26 34 27 27 27 27 27 27 27 27 27 27 33 26 24 0 0 0 0 0 0 0 0 0 0 0 0 0 0 0 0 0 0 0 0 0 0 0 0 0 0 0 0 17
24 0 0 0 0 15 13 13 13 13 13 13 13 13 13 13 13 13 13 13 14 0 0 0 0 0 0 0 0 0 0 0 0 0 0 0 0 0 0 0 0 0 0 0 0 0 0 0 0 17
24 0 0 0 0 1 1 1 1 1 1 1 1 1 1 1 1 1 1 1 1 0 0 0 0 0 0 0 0 0 0 0 0 0 0 0 0 0 0 0 0 0 0 0 0 0 0 0 0 17
24 0 0 0 0 0 0 0 0 0 0 0 0 0 0 0 0 0 0 0 0 0 0 0 0 0 0 0 0 0 0 0 0 0 0 0 0 0 0 0 0 0 0 0 0 0 0 0 0 17
34 27 27 27 27 27 27 27 27 27 27 27 27 27 27 27 27 27 27 27 30 0 0 0 0 29 27 27 27 27 27 27 27 27 27 27 27 27 27 27 27 27 27 27 27 27 30 0 0 17
26 26 26 26 26 26 26 26 26 26 26 26 26 26 26 26 26 26 26 26 24 0 0 0 0 17 26 26 26 26 26 26 26 26 26 26 26 26 26 26 26 26 26 26 26 26 24 0 0 17
26 26 26 26 26 26 26 26 26 26 26 26 26 26 26 26 26 26 26 26 24 0 0 0 0 17 26 26 26 26 26 26 26 26 26 26 26 26 26 26 26 26 26 26 26 26 24 0 0 17
26 26 26 26 26 26 26 26 26 26 26 26 26 26 26 26 26 26 26 26 24 0 0 0 0 17 26 26 26 26 26 26 26 26 26 26 26 26 26 26 26 26 26 26 26 26 24 0 0 17
26 26 26 26 26 26 26 26 26 26 26 26 26 26 26 26 26 26 26 26 24 0 0 0 0 17 26 26 26 26 26 26 26 26 26 26 26 26 26 26 26 26 26 26 26 26 24 0 0 17
21 13 13 13 13 13 13 13 13 13 13 13 13 13 13 13 13 13 13 13 14 0 0 0 0 17 26 26 26 21 13 13 13 13 13 13 13 13 13 13 13 13 13 13 13 13 14 0 0 17
24 1 1 1 1 1 1 1 1 1 1 1 1 1 1 1 1 1 1 1 1 0 0 0 0 17 26 26 26 24 1 1 1 1 1 1 1 1 1 1 1 1 1 1 1 1 1 0 0 17
24 0 0 0 0 0 0 0 0 0 0 0 0 0 0 0 0 0 0 0 0 0 0 0 0 17 26 26 26 24 31 0 0 0 0 0 0 0 0 0 0 0 0 0 0 0 0 0 0 17
24 0 0 0 0 0 0 0 0 0 0 0 0 0 0 0 0 0 0 0 0 0 0 0 0 17 26 26 26 24 31 0 0 0 0 0 0 0 31 0 0 0 0 0 0 0 0 0 0 17
24 0 0 0 0 0 0 0 0 0 0 0 0 0 0 0 0 0 0 0 0 0 0 0 0 17 26 26 26 24 0 0 0 0 0 0 0 0 0 0 0 0 0 0 0 0 0 0 0 17
24 0 0 0 0 0 0 0 0 0 0 0 0 0 0 0 0 0 0 0 0 0 0 0 0 17 26 26 26 24 0 0 0 0 0 0 0 0 0 0 0 0 0 0 0 0 0 31 0 17
24 0 0 0 0 0 0 0 0 0 0 0 0 0 0 0 0 0 0 0 0 0 0 0 0 17 26 26 26 24 0 0 0 0 0 0 0 0 0 0 0 31 0 0 0 0 0 0 0 17
24 0 0 0 0 0 0 0 0 0 0 0 0 0 0 0 0 0 0 0 0 0 0 0 0 15 13 13 13 14 29 27 27 27 27 27 27 27 27 27 27 27 27 27 27 27 27 27 27 17
24 0 0 0 0 0 0 0 0 0 0 0 0 0 0 0 0 0 0 0 0 0 0 0 0 1 1 1 1 1 17 26 26 26 26 26 26 26 26 26 26 26 26 26 26 26 26 26 26 26
24 0 0 0 0 0 0 0 0 0 0 0 0 0 0 0 0 0 0 0 0 0 0 0 0 0 0 0 0 0 17 26 26 26 26 26 26 26 26 26 26 26 26 26 26 26 26 26 26 26
24 0 0 0 0 0 0 0 0 0 0 0 0 0 0 0 0 0 0 0 0 0 0 0 0 0 0 0 0 0 17 26 26 26 26 26 26 26 26 26 26 26 26 26 26 26 26 26 26 26
24 0 0 0 0 0 0 0 0 0 0 0 0 0 0 0 0 0 0 0 0 0 0 0 0 0 0 0 0 0 15 13 13 13 13 13 13 13 13 13 13 13 13 13 13 13 13 13 13 20
24 0 0 0 0 0 0 0 0 0 0 0 0 0 0 0 0 0 0 0 0 0 0 0 0 0 0 0 0 0 1 1 1 1 1 1 1 1 1 1 1 1 1 1 1 1 1 1 0 17
24 0 0 0 0 0 0 0 0 0 0 0 0 0 0 0 0 0 0 0 0 0 0 0 0 0 0 0 0 0 0 0 0 0 0 0 0 0 0 0 0 0 0 0 0 0 0 0 0 17
24 0 0 0 0 0 0 0 0 0 0 0 0 0 0 0 0 0 0 0 0 0 0 0 0 0 0 0 0 0 0 0 0 0 0 0 0 0 0 0 0 0 0 0 0 0 0 0 0 17
24 0 0 0 0 0 0 0 0 0 0 0 0 0 0 0 0 0 0 0 0 0 0 0 0 0 0 0 0 0 0 0 0 0 0 0 0 0 0 0 0 0 0 0 0 0 0 0 0 17
24 0 0 0 0 0 0 0 0 0 0 0 0 0 0 0 0 0 0 0 0 0 0 0 0 0 0 0 0 0 0 0 0 0 0 0 0 0 0 0 0 0 0 0 0 0 0 0 9 17
24 0 0 0 0 0 0 0 0 0 0 0 0 0 0 0 0 0 0 0 0 0 0 0 0 0 0 0 0 0 0 0 0 0 0 0 0 0 0 0 0 0 0 0 0 0 0 0 0 17
34 27 27 27 27 27 27 27 27 27 27 27 27 27 27 27 27 27 27 27 27 27 27 27 27 27 27 27 27 27 27 27 27 27 27 27 27 27 27 27 27 27 27 27 27 27 27 27 27 33

