5 5 4 0 0 0 0 0 0 0 0 0 0 9 0 0
5 5 4 0 0 0 0 0 0 0 0 0 0 0 0 0
5 5 5 4 0 0 0 0 0 0 0 0 0 0 0 0
5 5 5 0 0 0 0 0 0 0 0 0 0 0 0 0
5 4 0 0 0 0 0 0 0 0 0 0 0 0 0 0
5 4 0 0 0 0 0 0 0 0 0 0 0 0 0 0
5 4 0 0 0 0 0 0 0 0 0 0 0 0 0 0
5 5 0 0 0 0 0 0 0 0 0 0 0 0 0 0
5 5 0 0 0 0 0 0 0 0 0 0 0 0 0 0
5 5 5 6 6 6 6 6 6 6 6 6 6 6 6 6
5 5 5 5 5 5 5 5 5 5 5 5 5 5 5 5
5 5 5 5 5 5 5 5 5 5 5 5 5 5 5 5