21 13 13 13 13 13 13 13 13 13 20 26 21 13 13 13 13 13 13 13 13 13 13 13 13 13 13 13 13 13 13 13 13 13 13 13 13 13 13 13 13 13 13 13 13 13 13 13 13 20
24 1 1 1 1 1 1 1 1 1 17 26 24 1 1 1 1 1 17 26 24 1 1 1 1 1 17 26 24 1 1 1 1 1 1 1 1 1 1 1 1 1 1 1 1 1 1 1 1 17
24 0 0 0 0 0 0 0 0 0 17 26 24 28 0 0 0 0 17 26 24 0 0 0 0 0 17 26 24 0 0 0 0 0 0 0 0 0 0 0 0 0 0 0 0 0 0 0 0 17
24 0 0 0 0 0 0 0 0 0 17 26 24 0 0 0 0 0 17 26 24 0 0 0 0 0 17 26 24 0 0 0 0 0 0 0 0 0 0 0 0 0 0 0 0 0 0 0 0 17
24 0 0 0 0 0 0 0 0 0 15 13 14 0 0 0 0 0 17 26 24 0 0 0 0 0 17 26 24 0 0 0 0 0 0 0 0 0 0 0 0 0 0 0 0 0 0 0 0 17
24 0 0 0 0 0 0 0 0 0 0 0 0 0 0 0 0 0 17 26 24 0 0 0 0 0 17 26 24 0 0 0 0 0 0 0 0 0 0 0 0 0 0 0 0 0 0 0 0 17
24 0 0 0 0 0 0 0 0 0 0 0 0 0 0 0 0 0 17 26 24 0 0 0 0 0 17 26 24 0 0 0 0 0 0 0 0 0 0 0 0 0 0 0 0 0 0 0 0 17
24 0 0 0 0 0 0 0 0 0 29 27 30 0 0 0 0 0 17 26 24 0 0 0 0 0 17 26 24 0 0 0 0 0 0 0 0 0 0 0 0 0 0 0 0 0 0 0 0 17
24 0 0 0 0 0 0 0 0 0 18 26 24 0 0 0 0 0 17 26 24 0 0 0 0 0 15 13 14 0 0 0 0 0 0 0 0 0 0 0 0 0 0 0 0 0 0 0 0 17
26 27 27 27 27 27 27 27 27 27 26 26 24 0 0 0 0 0 15 13 14 0 0 0 0 0 0 0 0 0 0 0 0 0 0 0 0 0 0 0 0 0 0 0 0 0 0 0 0 17
26 26 26 26 26 26 26 26 26 26 26 26 24 0 0 0 0 0 0 0 0 0 0 0 0 0 0 0 0 0 0 0 0 0 0 0 0 0 0 0 0 0 0 0 0 0 0 0 0 17
26 13 13 13 13 13 13 13 13 13 13 13 14 0 0 0 0 0 0 0 0 0 0 0 0 0 0 0 0 0 0 0 0 0 0 0 0 0 0 0 0 0 0 0 0 0 0 0 0 17
24 1 1 1 1 1 1 1 1 1 1 1 1 0 0 0 0 0 29 27 30 0 0 0 0 0 0 0 0 0 0 0 0 0 0 0 0 0 0 0 0 0 0 0 0 0 0 0 0 17
24 0 0 0 0 0 0 0 0 0 0 0 0 0 0 0 0 0 17 26 24 0 0 0 0 0 0 0 0 0 0 0 0 0 0 0 0 0 0 0 0 0 0 0 0 0 0 0 0 17
24 0 0 0 0 0 0 0 0 0 0 0 0 0 0 0 0 0 17 26 24 0 0 0 0 0 0 0 0 0 0 0 0 0 0 0 0 0 0 0 0 0 0 0 0 0 0 0 0 17
24 27 27 27 27 27 27 27 27 27 27 27 27 30 0 0 0 0 17 26 26 27 27 27 27 27 27 27 27 27 27 27 27 27 27 27 27 27 27 27 27 27 27 27 27 27 27 27 27 30
24 26 26 26 26 26 26 26 26 26 26 26 26 24 0 0 0 0 17 26 26 26 26 26 26 26 26 26 26 26 26 26 26 26 26 26 26 26 26 26 26 26 26 26 26 26 26 26 26 24
24 26 26 26 26 26 26 26 26 26 26 26 26 24 0 0 0 0 17 26 26 26 26 26 26 26 26 26 26 26 26 26 26 26 26 26 26 26 26 26 26 26 26 26 26 26 26 26 26 24
24 13 13 13 13 13 13 13 13 13 13 13 13 14 0 0 0 0 17 26 26 13 13 13 13 13 13 13 13 13 13 13 13 13 13 13 13 13 13 13 13 13 13 13 13 13 13 13 13 14
24 1 1 1 1 1 1 1 1 1 1 1 1 1 0 0 0 0 17 26 24 1 1 1 1 1 1 1 1 1 1 1 1 1 1 1 1 1 1 1 1 1 1 1 1 1 1 1 1 17
24 0 0 0 0 0 0 0 0 0 0 0 0 0 0 0 0 0 17 26 24 0 0 0 0 0 0 0 0 0 0 0 0 0 0 0 0 0 0 0 0 0 0 0 0 0 0 0 0 17
24 0 0 0 0 29 27 30 0 0 0 0 0 0 0 0 0 0 17 26 24 0 0 0 0 0 0 0 0 0 0 0 0 0 0 0 0 0 0 0 0 0 0 0 0 0 0 0 0 17
24 0 0 0 0 17 26 26 27 27 27 27 27 27 27 27 27 27 26 26 24 0 0 0 0 0 0 0 0 0 0 0 0 0 0 0 0 0 0 0 0 0 0 0 0 0 0 0 0 17
24 0 0 0 0 15 13 13 13 13 13 13 13 13 13 13 13 13 13 13 14 0 0 0 0 0 0 0 0 0 0 0 0 0 0 0 0 0 0 0 0 0 0 0 0 0 0 0 0 17
24 0 0 0 0 1 1 1 1 1 1 1 1 1 1 1 1 1 1 1 1 0 0 0 0 0 0 0 0 0 0 0 0 0 0 0 0 0 0 0 0 0 0 0 0 0 0 0 0 17
24 0 0 0 0 0 0 0 0 0 0 0 0 0 0 0 0 0 0 0 0 0 0 0 0 0 0 0 0 0 0 0 0 0 0 0 0 0 0 0 0 0 0 0 0 0 0 0 0 17
24 27 27 27 27 27 27 27 27 27 27 27 27 27 27 27 27 27 27 27 30 0 0 0 0 29 27 27 27 27 27 27 27 27 27 27 27 27 27 27 27 27 27 27 27 27 30 0 0 17
24 26 26 26 26 26 26 26 26 26 26 26 26 26 26 26 26 26 26 26 24 0 0 0 0 17 26 26 26 26 26 26 26 26 26 26 26 26 26 26 26 26 26 26 26 26 24 0 0 17
24 26 26 26 26 26 26 26 26 26 26 26 26 26 26 26 26 26 26 26 24 0 0 0 0 17 26 26 26 26 26 26 26 26 26 26 26 26 26 26 26 26 26 26 26 26 24 0 0 17
24 26 26 26 26 26 26 26 26 26 26 26 26 26 26 26 26 26 26 26 24 0 0 0 0 17 26 26 26 26 26 26 26 26 26 26 26 26 26 26 26 26 26 26 26 26 24 0 0 17
24 26 26 26 26 26 26 26 26 26 26 26 26 26 26 26 26 26 26 26 24 0 0 0 0 17 26 26 26 26 26 26 26 26 26 26 26 26 26 26 26 26 26 26 26 26 24 0 0 17
24 13 13 13 13 13 13 13 13 13 13 13 13 13 13 13 13 13 13 13 14 0 0 0 0 15 13 13 13 13 13 13 13 13 13 13 13 13 13 13 13 13 13 13 13 13 14 0 0 17
24 0 0 0 0 0 0 0 0 0 2 2 2 2 2 2 0 0 0 0 9 0 0 0 0 17 26 26 26 24 1 1 1 1 1 1 1 1 1 1 1 1 1 1 1 1 1 0 0 17
24 0 0 0 0 0 0 0 0 0 0 2 2 2 2 2 0 0 0 0 9 0 0 0 0 17 26 26 26 24 0 0 0 0 0 0 0 0 0 0 0 0 0 0 0 0 0 0 0 17
24 0 0 0 0 0 0 0 0 0 0 0 2 2 2 2 0 0 0 0 9 0 0 0 0 17 26 26 26 24 0 0 0 0 0 0 0 0 0 0 0 0 0 0 0 0 0 0 0 17
24 0 0 0 0 0 0 0 0 0 0 0 0 2 2 2 0 0 0 0 9 0 0 0 0 17 26 26 26 24 0 0 0 0 0 0 0 0 0 0 0 0 0 0 0 0 0 0 0 17
24 0 0 0 0 0 0 0 0 0 0 0 0 0 2 2 0 0 0 0 9 0 0 0 0 17 26 26 26 24 0 0 0 0 0 0 0 0 0 0 0 0 0 0 0 0 0 0 0 17
24 0 0 0 0 0 0 0 0 0 0 0 0 0 0 2 0 0 0 0 9 0 0 0 0 17 26 26 26 24 0 0 0 0 0 0 0 0 0 0 0 0 0 0 0 0 0 0 0 17
24 0 0 0 9 0 0 0 0 0 2 2 2 2 2 2 0 0 0 0 9 0 0 0 0 15 13 13 13 14 29 27 27 27 27 27 27 27 27 27 27 27 27 27 27 27 27 27 27 17
24 0 0 0 0 0 0 0 0 0 2 2 2 2 2 2 0 0 0 0 9 0 0 0 0 0 2 2 2 0 17 26 26 26 26 26 26 26 26 26 26 26 26 26 26 26 26 26 26 17
24 0 0 0 0 0 0 0 0 2 2 2 2 2 2 2 0 0 0 0 9 0 0 0 0 0 2 2 2 0 17 26 26 26 26 26 26 26 26 26 26 26 26 26 26 26 26 26 26 17
24 0 0 0 0 0 0 0 2 2 2 2 2 2 2 2 0 0 0 0 9 0 0 0 0 0 2 2 2 0 17 26 26 26 26 26 26 26 26 26 26 26 26 26 26 26 26 26 26 17
24 0 0 0 0 0 0 0 2 2 2 2 2 2 2 2 0 0 0 0 9 0 0 0 0 0 2 2 2 2 15 13 13 13 13 13 13 13 13 13 13 13 13 13 13 13 13 13 13 17
24 0 0 0 0 0 0 0 0 2 2 2 2 2 2 2 0 0 0 0 9 0 0 0 0 0 2 2 2 2 2 2 0 0 0 0 0 0 9 0 0 0 0 0 2 2 2 2 2 17
24 0 0 0 0 0 0 0 0 0 2 2 2 2 2 2 0 0 0 0 9 0 0 0 0 0 2 2 2 2 2 2 0 0 0 0 0 0 9 0 0 0 0 0 2 2 2 2 2 17
24 0 0 0 0 0 0 0 0 0 0 2 2 2 2 2 0 0 0 0 9 0 0 0 0 0 2 2 2 2 2 2 0 0 0 0 0 0 9 0 0 0 0 0 2 2 2 2 2 17
24 0 0 0 0 0 0 0 0 0 0 0 2 2 2 2 0 0 0 0 9 0 0 0 0 0 2 2 2 2 2 2 0 0 0 0 0 0 9 0 0 0 0 0 2 2 2 2 2 17
24 0 0 0 0 0 0 0 0 0 0 0 0 2 2 2 0 0 0 0 9 0 0 0 0 0 2 2 2 2 2 2 0 0 0 0 0 0 9 0 0 0 0 0 2 2 2 2 0 17
24 0 0 0 0 0 0 0 0 0 0 0 0 0 2 2 0 0 0 0 9 0 0 0 0 0 2 2 2 2 2 2 0 0 0 0 0 0 9 0 0 0 0 0 2 2 2 2 0 17
26 27 27 27 27 27 27 27 27 27 27 27 27 27 27 27 27 27 27 27 27 27 27 27 27 27 27 27 27 27 27 27 27 27 27 27 27 27 27 27 27 27 27 27 27 27 27 27 27 14
